1111111111111
1P00000000001
1000000000001
1000000000001
1000010100001
1000010100001
1000110110001
100000C000001
10001101100H1
1000010100H01
100001010H001
10000000H0001
1000000H00001
100000H0000E1
1111111111111