11111111111111111
1P100010H01000101
100010001000100C1
101C0H10001000101
1000100010C01H001
10100010001000101
10H01C001000100E1
11111111111111111