11111111111111111
1C10H101000000001
10000000001C10001
11111110111110001
1000H00000000C101
101111011111011H1
1P0000000000000E1
11111111111111111