11111111111111111
1C00H001000C100C1
10010000010010001
100100100100H0001
10110011000010001
10011000000000001
1P0000EH0C001C001
11111111111111111