11111111111111111
1C0000H0000000001
11100111000110001
10000000E00010001
10H01110000000H01
10001P00001111001
100C1000000C010C1
11111111111111111