11111111
100000C1
10110111
101C0001
10100H01
10101101
101000C1
1000H001
10100001
10110101
1E1P0001
11111111