11111111111111111
1C0000000000000C1
10H01000000010H01
10000000000000001
10000010101000001
10010010E01001001
10000010001000001
100H001111100H001
10000010001000001
10010010P01001001
10000010101000001
10000000000000001
10H01000000010H01
1C0000000000000C1
11111111111111111